111111111111111111111111111111
11111111111111100000000000C011
1111111111111110E0000000011111
110000000000000111111100000011
110000000000000111111100100011
110000C00000000000000000000111
110000110000000000000000010011
11000000000000C000000010000011
110000000000000000110000000011
111111111111111111111111111111
111111111111111111111111111111
