1111111111111111111
1000000000000000001
1000000000001000001
1000010000000000001
1000000000010000001
1000000000000000001
1111111111111111111
