111111111111111111111111111111111
111111111111111111111111111111111
11000000M00000000000000M100000011
110000000000000M00000000000000011
110E0000000M000000000000000000011
111111100000000M00000000000M00011
1111111000010000000000C0000000011
110000000001000000000010000000011
110000M00000000000000111000000011
110000001100001110000111000011111
1100000M00000011100000C0000011111
1100P00000000C11100M0100000011111
111111111111111111111111111111111
111111111111111111111111111111111
