1111111111111111111111111111
11111111100000M0000000000011
1111111110C00000000M00000011
11111111111111100M0000000011
111111111111100C0000M0001111
1111111111110000000000111111
1111111111000000M0C011111111
11111111000000M0001111111111
1100000000M00001111111111111
110E000P00000111111111111111
1111111111111111111111111111
