111111111111111111111111111111
111111111111111000M0000000C011
1111111111111110E000M000011111
110000000000000111111100000011
1100000M0000000111111100100011
110000C00000000000000000000111
110000110000000000M00000010011
11000000000000C000000010000011
11000P00000M000000110000000011
111111111111111111111111111111
111111111111111111111111111111
