111111111111111111111
111111111000000000011
110000000000010111011
110000000000000000011
110E00000000000000011
111111110001111100111
110000111111100000111
1100P0000000000000011
111111111111111111111
