111111111111111111111111111111111
111111111111111111111111111111111
110000000000000000000000000000011
110000000000000000000000000000011
110E00000000000P00000000000000011
111111100000000000000000000000011
1111111000010000000000C0000000011
110000000001000000000010000000011
110000000000000P0000011100000C011
110000001100001110000111000011111
1100000000000011100000C0000011111
110000000000C11100000000000011111
111111111111111111111111111111111
111111111111111111111111111111111
