1111111111111111111111111111
1111111110000000000000000011
1111111110000000000000000011
1111111111111110000000000011
1111111111111000000000001111
1111111111110000000000111111
1111111111000000000011111111
1111111100000000001111111111
1100000000P00001111111111111
110E000000000111111111111111
1111111111111111111111111111
