111111111111111111111
111111111000000000011
110000000000010111011
110000000000000000011
110E000000C0000000011
111111110001111111111
110000111111100000111
111111111000000010111
1100P0000000000C00011
111111111111111111111
