SO ./textures/three.xpm
NO ./textures/one.xpm
EA ./textures/two.xpm
WE ./textures/four.xpm

F 135, 206, 235
C 139, 69, 19

	1111111111111111111111111
	1000000000110000000000001
	101100000111000000N0000001
	1001000000000000000000001
111111111011000001110000000000001
100000000011000001110111111111111
11110111111111011100000010001
11110111111111011101010010001
11000000110101011110000010001
10000000000000001 100000010001
10000000000000001111010010001
1100000111010101111101111000111
11110111 1110101 101111010001
11111111 1111111 111111111111
