11111111111111111111
11111111111111000001
1111111111111100S001
11111111111111000001
11111111111111110111
1111111111111111001
1111111111111111101
1111111111111111101
1111111111111111101
1111111111111111101
1111111111000000001
1111111111101111111
1111111111101
1111111111101
11111111111011111111
10000000000000000001
10000000000000000001
10000000000000000001
10000000000000000001
11111111111111111111
