11111111111111111111
11111111111111000001
1111111111111100S001
11111111111111000001
1111111111111111D111
1111111111111111011
1111111111111111011
1111111111111111011
1111111111111111011
1111111111111111011
1111111111100000011
1111111111101111111
1111111111101
1111111111101
11111111111D11111111
10000000000000000001
10000000000000000001
10000000000000000001
100001C10000C00000C1
11111111111111111111
